    #########
    #       #
 ####ooo@@@ #
 #A @ooo@   #
##@@@ooo@#  #
# @ooooo@  ##
# @oo@@@@# #
# @oo@   # #
# @oo@ #   #
# @oo@#oo###
# @@@@oo #
#        #
#########$