#########
# ooo oo#
# ##    #
# #   # #
# @@@@@ #
# @A  @o#
# @@@@@o#
# ooooo##
#########